Date,Description,Amount,Running Balance,Bank_Account,Account_Type,Category1,Category2,Category3,Tags,Payer,Payee,YYYY,MM-YYYY,Q0-YYYY
2024-01-01,Salary Deposit,8500.0,8500.0,BOA_7259,income,Income,Salary,Primary Income,"essential,monthly",Employer,Self,2024,01-2024,Q1-2024
2024-01-02,Interest Payment,15.0,8515.0,BOA_7259,income,Income,Interest,Bank Interest,"essential,monthly",Bank,Self,2024,01-2024,Q1-2024
2024-01-03,Mortgage Payment,-3191.0,5324.0,BOA_7259,expense,Housing,Mortgage,Principal & Interest,"essential,monthly",Self,Bank,2024,01-2024,Q1-2024
2024-01-04,Utility Bill,-189.0,5135.0,BOA_7259,expense,Utilities,Electricity,Monthly Bill,"essential,monthly",Self,Utility Company,2024,01-2024,Q1-2024
2024-01-05,Internet Bill,-90.99,5044.01,BOA_7259,expense,Utilities,Internet,Monthly Service,"essential,monthly",Self,Internet Provider,2024,01-2024,Q1-2024
2024-01-06,Phone Bill,-88.0,4956.01,BOA_7259,expense,Utilities,Phone,Monthly Service,"essential,monthly",Self,Phone Company,2024,01-2024,Q1-2024
2024-01-07,Insurance Payment,-368.0,4588.01,BOA_7259,expense,Insurance,Health Insurance,Monthly Premium,"essential,monthly",Self,Insurance Company,2024,01-2024,Q1-2024
2024-01-08,Netflix Subscription,-2.99,4585.02,BOA_7259,expense,Entertainment,Streaming,Video Streaming,"luxury,monthly",Self,Netflix,2024,01-2024,Q1-2024
2024-01-09,Spotify Subscription,-28.990000000000002,4556.030000000001,BOA_7259,expense,Entertainment,Music,Streaming,"luxury,monthly",Self,Spotify,2024,01-2024,Q1-2024
2024-01-10,Transfer to Savings,-1013.0,3543.0300000000007,BOA_7259,expense,Transfer,Savings,Monthly Transfer,"essential,monthly",Self,Self,2024,01-2024,Q1-2024
2024-01-11,Transfer to Investment,-498.0,3045.0300000000007,BOA_7259,expense,Transfer,Investment,Monthly Investment,"essential,monthly",Self,Self,2024,01-2024,Q1-2024
2024-01-12,Transfer to Credit Card,-1497.0,1548.0300000000007,BOA_7259,expense,Transfer,Credit Card,Payment,"essential,monthly",Self,Self,2024,01-2024,Q1-2024
2024-01-13,ATM Withdrawal,-199.0,1349.0300000000007,BOA_7259,expense,Transfer,Cash,ATM Withdrawal,"essential,monthly",Self,Self,2024,01-2024,Q1-2024
2024-01-14,Grocery Store,-479.0,870.0300000000007,BOA_7259,expense,Food & Dining,Groceries,Daily Groceries,"essential,monthly",Self,Grocery Store,2024,01-2024,Q1-2024
2024-01-21,Grocery Store,-428.0,442.03000000000065,BOA_7259,expense,Food & Dining,Groceries,Daily Groceries,"essential,monthly",Self,Grocery Store,2024,01-2024,Q1-2024
2024-01-27,Grocery Store,-436.0,6.030000000000655,BOA_7259,expense,Food & Dining,Groceries,Daily Groceries,"essential,monthly",Self,Grocery Store,2024,01-2024,Q1-2024
2024-02-03,Grocery Store,-424.0,-417.96999999999935,BOA_7259,expense,Food & Dining,Groceries,Daily Groceries,"essential,monthly",Self,Grocery Store,2024,02-2024,Q1-2024
2024-02-07,Gas Station,-90.0,-507.96999999999935,BOA_7259,expense,Transportation,Fuel,Gasoline,"essential,monthly",Self,Gas Station,2024,02-2024,Q1-2024
2024-02-08,Gas Station,-51.0,-558.9699999999993,BOA_7259,expense,Transportation,Fuel,Gasoline,"essential,monthly",Self,Gas Station,2024,02-2024,Q1-2024
2024-02-10,Gas Station,-62.0,-620.9699999999993,BOA_7259,expense,Transportation,Fuel,Gasoline,"essential,monthly",Self,Gas Station,2024,02-2024,Q1-2024
2024-02-15,Starbucks,-19.0,-639.9699999999993,BOA_7259,expense,Food & Dining,Coffee,Takeout,"luxury,monthly",Self,Starbucks,2024,02-2024,Q1-2024
2024-02-20,Starbucks,-8.0,-647.9699999999993,BOA_7259,expense,Food & Dining,Coffee,Takeout,"luxury,monthly",Self,Starbucks,2024,02-2024,Q1-2024
2024-02-25,Starbucks,-28.0,-675.9699999999993,BOA_7259,expense,Food & Dining,Coffee,Takeout,"luxury,monthly",Self,Starbucks,2024,02-2024,Q1-2024
2024-03-01,Starbucks,5.0,-670.9699999999993,BOA_7259,expense,Food & Dining,Coffee,Takeout,"luxury,monthly",Self,Starbucks,2024,03-2024,Q1-2024
2024-03-02,Target,-98.0,-768.9699999999993,BOA_7259,expense,Shopping,Retail,Household Items,"essential,monthly",Self,Target,2024,03-2024,Q1-2024
2024-03-06,Target,-108.0,-876.9699999999993,BOA_7259,expense,Shopping,Retail,Household Items,"essential,monthly",Self,Target,2024,03-2024,Q1-2024
2024-03-13,Target,-111.0,-987.9699999999993,BOA_7259,expense,Shopping,Retail,Household Items,"essential,monthly",Self,Target,2024,03-2024,Q1-2024
2024-03-16,Costco,-206.0,-1193.9699999999993,BOA_7259,expense,Food & Dining,Groceries,Bulk Shopping,"essential,monthly",Self,Costco,2024,03-2024,Q1-2024
2024-03-23,Costco,-193.0,-1386.9699999999993,BOA_7259,expense,Food & Dining,Groceries,Bulk Shopping,"essential,monthly",Self,Costco,2024,03-2024,Q1-2024
2024-03-26,Costco,-243.0,-1629.9699999999993,BOA_7259,expense,Food & Dining,Groceries,Bulk Shopping,"essential,monthly",Self,Costco,2024,03-2024,Q1-2024
2024-04-02,Costco,-215.0,-1844.9699999999993,BOA_7259,expense,Food & Dining,Groceries,Bulk Shopping,"essential,monthly",Self,Costco,2024,04-2024,Q2-2024
2024-04-07,Pet Store,-44.0,-1888.9699999999993,BOA_7259,expense,Shopping,Pets,Pet Supplies,"essential,monthly",Self,Pet Store,2024,04-2024,Q2-2024
2024-04-13,Doctor Visit,-65.0,-1953.9699999999993,BOA_7259,expense,Healthcare,Medical,Primary Care,"essential,monthly",Self,Healthcare Provider,2024,04-2024,Q2-2024
2024-04-15,Oil Change,-27.0,-1980.9699999999993,BOA_7259,expense,Transportation,Car Maintenance,Service,"essential,monthly",Self,Car Service,2024,04-2024,Q2-2024
2024-04-19,Charity Donation,-122.0,-2102.9699999999993,BOA_7259,expense,Charity,Donations,Monthly Giving,"essential,monthly",Self,Charity,2024,04-2024,Q2-2024
2024-05-01,Salary Deposit,8500.0,6397.030000000001,BOA_7259,income,Income,Salary,Primary Income,"essential,monthly",Employer,Self,2024,05-2024,Q2-2024
2024-05-02,Interest Payment,15.0,6412.030000000001,BOA_7259,income,Income,Interest,Bank Interest,"essential,monthly",Bank,Self,2024,05-2024,Q2-2024
2024-05-03,Mortgage Payment,-3208.0,3204.0300000000007,BOA_7259,expense,Housing,Mortgage,Principal & Interest,"essential,monthly",Self,Bank,2024,05-2024,Q2-2024
2024-05-04,Utility Bill,-200.0,3004.0300000000007,BOA_7259,expense,Utilities,Electricity,Monthly Bill,"essential,monthly",Self,Utility Company,2024,05-2024,Q2-2024
2024-05-05,Internet Bill,-78.99,2925.040000000001,BOA_7259,expense,Utilities,Internet,Monthly Service,"essential,monthly",Self,Internet Provider,2024,05-2024,Q2-2024
2024-05-06,Phone Bill,-85.0,2840.040000000001,BOA_7259,expense,Utilities,Phone,Monthly Service,"essential,monthly",Self,Phone Company,2024,05-2024,Q2-2024
2024-05-07,Insurance Payment,-339.0,2501.040000000001,BOA_7259,expense,Insurance,Health Insurance,Monthly Premium,"essential,monthly",Self,Insurance Company,2024,05-2024,Q2-2024
2024-05-08,Netflix Subscription,-23.990000000000002,2477.050000000001,BOA_7259,expense,Entertainment,Streaming,Video Streaming,"luxury,monthly",Self,Netflix,2024,05-2024,Q2-2024
2024-05-09,Spotify Subscription,-11.99,2465.0600000000013,BOA_7259,expense,Entertainment,Music,Streaming,"luxury,monthly",Self,Spotify,2024,05-2024,Q2-2024
2024-05-10,Transfer to Savings,-989.0,1476.0600000000013,BOA_7259,expense,Transfer,Savings,Monthly Transfer,"essential,monthly",Self,Self,2024,05-2024,Q2-2024
2024-05-11,Transfer to Investment,-517.0,959.0600000000013,BOA_7259,expense,Transfer,Investment,Monthly Investment,"essential,monthly",Self,Self,2024,05-2024,Q2-2024
2024-05-12,Transfer to Credit Card,-1504.0,-544.9399999999987,BOA_7259,expense,Transfer,Credit Card,Payment,"essential,monthly",Self,Self,2024,05-2024,Q2-2024
2024-05-13,ATM Withdrawal,-185.0,-729.9399999999987,BOA_7259,expense,Transfer,Cash,ATM Withdrawal,"essential,monthly",Self,Self,2024,05-2024,Q2-2024
2024-05-14,Grocery Store,-447.0,-1176.9399999999987,BOA_7259,expense,Food & Dining,Groceries,Daily Groceries,"essential,monthly",Self,Grocery Store,2024,05-2024,Q2-2024
2024-05-17,Grocery Store,-471.0,-1647.9399999999987,BOA_7259,expense,Food & Dining,Groceries,Daily Groceries,"essential,monthly",Self,Grocery Store,2024,05-2024,Q2-2024
2024-05-21,Grocery Store,-476.0,-2123.9399999999987,BOA_7259,expense,Food & Dining,Groceries,Daily Groceries,"essential,monthly",Self,Grocery Store,2024,05-2024,Q2-2024
2024-05-28,Grocery Store,-460.0,-2583.9399999999987,BOA_7259,expense,Food & Dining,Groceries,Daily Groceries,"essential,monthly",Self,Grocery Store,2024,05-2024,Q2-2024
2024-06-03,Gas Station,-68.0,-2651.9399999999987,BOA_7259,expense,Transportation,Fuel,Gasoline,"essential,monthly",Self,Gas Station,2024,06-2024,Q2-2024
2024-06-07,Gas Station,-69.0,-2720.9399999999987,BOA_7259,expense,Transportation,Fuel,Gasoline,"essential,monthly",Self,Gas Station,2024,06-2024,Q2-2024
2024-06-09,Gas Station,-57.0,-2777.9399999999987,BOA_7259,expense,Transportation,Fuel,Gasoline,"essential,monthly",Self,Gas Station,2024,06-2024,Q2-2024
2024-06-13,Starbucks,-32.0,-2809.9399999999987,BOA_7259,expense,Food & Dining,Coffee,Takeout,"luxury,monthly",Self,Starbucks,2024,06-2024,Q2-2024
2024-06-18,Starbucks,-28.0,-2837.9399999999987,BOA_7259,expense,Food & Dining,Coffee,Takeout,"luxury,monthly",Self,Starbucks,2024,06-2024,Q2-2024
2024-06-23,Starbucks,-25.0,-2862.9399999999987,BOA_7259,expense,Food & Dining,Coffee,Takeout,"luxury,monthly",Self,Starbucks,2024,06-2024,Q2-2024
2024-06-24,Target,-112.0,-2974.9399999999987,BOA_7259,expense,Shopping,Retail,Household Items,"essential,monthly",Self,Target,2024,06-2024,Q2-2024
2024-07-01,Target,-60.0,-3034.9399999999987,BOA_7259,expense,Shopping,Retail,Household Items,"essential,monthly",Self,Target,2024,07-2024,Q3-2024
2024-07-02,Target,-62.0,-3096.9399999999987,BOA_7259,expense,Shopping,Retail,Household Items,"essential,monthly",Self,Target,2024,07-2024,Q3-2024
2024-07-05,Costco,-209.0,-3305.9399999999987,BOA_7259,expense,Food & Dining,Groceries,Bulk Shopping,"essential,monthly",Self,Costco,2024,07-2024,Q3-2024
2024-07-12,Costco,-239.0,-3544.9399999999987,BOA_7259,expense,Food & Dining,Groceries,Bulk Shopping,"essential,monthly",Self,Costco,2024,07-2024,Q3-2024
2024-07-16,Pet Store,-28.0,-3572.9399999999987,BOA_7259,expense,Shopping,Pets,Pet Supplies,"essential,monthly",Self,Pet Store,2024,07-2024,Q3-2024
2024-07-22,Doctor Visit,-32.0,-3604.9399999999987,BOA_7259,expense,Healthcare,Medical,Primary Care,"essential,monthly",Self,Healthcare Provider,2024,07-2024,Q3-2024
2024-07-31,Pharmacy,-33.0,-3637.9399999999987,BOA_7259,expense,Healthcare,Prescriptions,Medication,"essential,monthly",Self,Pharmacy,2024,07-2024,Q3-2024
2024-08-06,Amazon Purchase,-84.0,-3721.9399999999987,BOA_7259,expense,Shopping,Online Shopping,Electronics,"luxury,one-time",Self,Amazon,2024,08-2024,Q3-2024
2024-08-12,Bookstore,-50.0,-3771.9399999999987,BOA_7259,expense,Education,Books,Personal Development,"luxury,one-time",Self,Bookstore,2024,08-2024,Q3-2024
2024-08-18,Mother's Day Gift,-120.0,-3891.9399999999987,BOA_7259,expense,Shopping,Gifts,Holiday,"luxury,one-time",Self,Retail Store,2024,08-2024,Q3-2024
2024-09-01,Salary Deposit,8500.0,4608.060000000001,BOA_7259,income,Income,Salary,Primary Income,"essential,monthly",Employer,Self,2024,09-2024,Q3-2024
2024-09-02,Interest Payment,12.0,4620.060000000001,BOA_7259,income,Income,Interest,Bank Interest,"essential,monthly",Bank,Self,2024,09-2024,Q3-2024
2024-09-03,Mortgage Payment,-3186.0,1434.0600000000013,BOA_7259,expense,Housing,Mortgage,Principal & Interest,"essential,monthly",Self,Bank,2024,09-2024,Q3-2024
2024-09-04,Utility Bill,-201.0,1233.0600000000013,BOA_7259,expense,Utilities,Electricity,Monthly Bill,"essential,monthly",Self,Utility Company,2024,09-2024,Q3-2024
2024-09-05,Internet Bill,-106.99,1126.0700000000013,BOA_7259,expense,Utilities,Internet,Monthly Service,"essential,monthly",Self,Internet Provider,2024,09-2024,Q3-2024
2024-09-06,Phone Bill,-115.0,1011.0700000000013,BOA_7259,expense,Utilities,Phone,Monthly Service,"essential,monthly",Self,Phone Company,2024,09-2024,Q3-2024
2024-09-07,Insurance Payment,-344.0,667.0700000000013,BOA_7259,expense,Insurance,Health Insurance,Monthly Premium,"essential,monthly",Self,Insurance Company,2024,09-2024,Q3-2024
2024-09-08,Netflix Subscription,-13.99,653.0800000000013,BOA_7259,expense,Entertainment,Streaming,Video Streaming,"luxury,monthly",Self,Netflix,2024,09-2024,Q3-2024
2024-09-09,Spotify Subscription,3.01,656.0900000000013,BOA_7259,expense,Entertainment,Music,Streaming,"luxury,monthly",Self,Spotify,2024,09-2024,Q3-2024
2024-09-10,Transfer to Savings,-1014.0,-357.9099999999987,BOA_7259,expense,Transfer,Savings,Monthly Transfer,"essential,monthly",Self,Self,2024,09-2024,Q3-2024
2024-09-11,Transfer to Investment,-482.0,-839.9099999999987,BOA_7259,expense,Transfer,Investment,Monthly Investment,"essential,monthly",Self,Self,2024,09-2024,Q3-2024
2024-09-12,Transfer to Credit Card,-1496.0,-2335.909999999999,BOA_7259,expense,Transfer,Credit Card,Payment,"essential,monthly",Self,Self,2024,09-2024,Q3-2024
2024-09-13,ATM Withdrawal,-206.0,-2541.909999999999,BOA_7259,expense,Transfer,Cash,ATM Withdrawal,"essential,monthly",Self,Self,2024,09-2024,Q3-2024
2024-09-14,Grocery Store,-468.0,-3009.909999999999,BOA_7259,expense,Food & Dining,Groceries,Daily Groceries,"essential,monthly",Self,Grocery Store,2024,09-2024,Q3-2024
2024-09-20,Grocery Store,-429.0,-3438.909999999999,BOA_7259,expense,Food & Dining,Groceries,Daily Groceries,"essential,monthly",Self,Grocery Store,2024,09-2024,Q3-2024
2024-09-21,Grocery Store,-474.0,-3912.909999999999,BOA_7259,expense,Food & Dining,Groceries,Daily Groceries,"essential,monthly",Self,Grocery Store,2024,09-2024,Q3-2024
2024-09-24,Gas Station,-87.0,-3999.909999999999,BOA_7259,expense,Transportation,Fuel,Gasoline,"essential,monthly",Self,Gas Station,2024,09-2024,Q3-2024
2024-09-29,Gas Station,-57.0,-4056.909999999999,BOA_7259,expense,Transportation,Fuel,Gasoline,"essential,monthly",Self,Gas Station,2024,09-2024,Q3-2024
2024-10-05,Starbucks,7.0,-4049.909999999999,BOA_7259,expense,Food & Dining,Coffee,Takeout,"luxury,monthly",Self,Starbucks,2024,10-2024,Q4-2024
2024-10-10,Starbucks,22.0,-4027.909999999999,BOA_7259,expense,Food & Dining,Coffee,Takeout,"luxury,monthly",Self,Starbucks,2024,10-2024,Q4-2024
2024-10-12,Starbucks,5.0,-4022.909999999999,BOA_7259,expense,Food & Dining,Coffee,Takeout,"luxury,monthly",Self,Starbucks,2024,10-2024,Q4-2024
2024-10-16,Starbucks,-2.0,-4024.909999999999,BOA_7259,expense,Food & Dining,Coffee,Takeout,"luxury,monthly",Self,Starbucks,2024,10-2024,Q4-2024
2024-10-19,Target,-70.0,-4094.909999999999,BOA_7259,expense,Shopping,Retail,Household Items,"essential,monthly",Self,Target,2024,10-2024,Q4-2024
2024-10-24,Target,-71.0,-4165.909999999999,BOA_7259,expense,Shopping,Retail,Household Items,"essential,monthly",Self,Target,2024,10-2024,Q4-2024
2024-10-28,Target,-80.0,-4245.909999999999,BOA_7259,expense,Shopping,Retail,Household Items,"essential,monthly",Self,Target,2024,10-2024,Q4-2024
2024-11-02,Target,-104.0,-4349.909999999999,BOA_7259,expense,Shopping,Retail,Household Items,"essential,monthly",Self,Target,2024,11-2024,Q4-2024
2024-11-03,Costco,-235.0,-4584.909999999999,BOA_7259,expense,Food & Dining,Groceries,Bulk Shopping,"essential,monthly",Self,Costco,2024,11-2024,Q4-2024
2024-11-09,Costco,-242.0,-4826.909999999999,BOA_7259,expense,Food & Dining,Groceries,Bulk Shopping,"essential,monthly",Self,Costco,2024,11-2024,Q4-2024
2024-11-15,Restaurant,-93.0,-4919.909999999999,BOA_7259,expense,Food & Dining,Dining Out,Casual Dining,"luxury,monthly",Self,Restaurant,2024,11-2024,Q4-2024
2024-11-21,Movie Theater,-74.0,-4993.909999999999,BOA_7259,expense,Entertainment,Movies,Cinema,"luxury,monthly",Self,Movie Theater,2024,11-2024,Q4-2024
2024-11-22,Clothing Store,-142.0,-5135.909999999999,BOA_7259,expense,Shopping,Clothing,Apparel,"luxury,monthly",Self,Clothing Store,2024,11-2024,Q4-2024
2024-11-24,Doctor Visit,-53.0,-5188.909999999999,BOA_7259,expense,Healthcare,Medical,Primary Care,"essential,monthly",Self,Healthcare Provider,2024,11-2024,Q4-2024
2024-11-26,Pharmacy,-29.0,-5217.909999999999,BOA_7259,expense,Healthcare,Prescriptions,Medication,"essential,monthly",Self,Pharmacy,2024,11-2024,Q4-2024
2024-12-01,Car Wash,-38.0,-5255.909999999999,BOA_7259,expense,Transportation,Car Maintenance,Cleaning,"essential,monthly",Self,Car Wash,2024,12-2024,Q4-2024
2024-12-03,Oil Change,-53.0,-5308.909999999999,BOA_7259,expense,Transportation,Car Maintenance,Service,"essential,monthly",Self,Car Service,2024,12-2024,Q4-2024
2024-12-05,Amazon Purchase,-97.0,-5405.909999999999,BOA_7259,expense,Shopping,Online Shopping,Electronics,"luxury,one-time",Self,Amazon,2024,12-2024,Q4-2024
2024-12-15,Back to School Shopping,-300.0,-5705.909999999999,BOA_7259,expense,Education,School Supplies,Annual,"essential,annual",Self,Retail Store,2024,12-2024,Q4-2024
2025-01-01,Salary Deposit,8500.0,2794.090000000001,BOA_7259,income,Income,Salary,Primary Income,"essential,monthly",Employer,Self,2025,01-2025,Q1-2025
2025-01-02,Interest Payment,16.0,2810.090000000001,BOA_7259,income,Income,Interest,Bank Interest,"essential,monthly",Bank,Self,2025,01-2025,Q1-2025
2025-01-03,Mortgage Payment,-3199.0,-388.90999999999894,BOA_7259,expense,Housing,Mortgage,Principal & Interest,"essential,monthly",Self,Bank,2025,01-2025,Q1-2025
2025-01-04,Utility Bill,-205.0,-593.909999999999,BOA_7259,expense,Utilities,Electricity,Monthly Bill,"essential,monthly",Self,Utility Company,2025,01-2025,Q1-2025
2025-01-05,Internet Bill,-81.99,-675.899999999999,BOA_7259,expense,Utilities,Internet,Monthly Service,"essential,monthly",Self,Internet Provider,2025,01-2025,Q1-2025
2025-01-06,Phone Bill,-91.0,-766.899999999999,BOA_7259,expense,Utilities,Phone,Monthly Service,"essential,monthly",Self,Phone Company,2025,01-2025,Q1-2025
2025-01-07,Insurance Payment,-334.0,-1100.899999999999,BOA_7259,expense,Insurance,Health Insurance,Monthly Premium,"essential,monthly",Self,Insurance Company,2025,01-2025,Q1-2025
2025-01-08,Netflix Subscription,-20.990000000000002,-1121.889999999999,BOA_7259,expense,Entertainment,Streaming,Video Streaming,"luxury,monthly",Self,Netflix,2025,01-2025,Q1-2025
2025-01-09,Spotify Subscription,-19.990000000000002,-1141.879999999999,BOA_7259,expense,Entertainment,Music,Streaming,"luxury,monthly",Self,Spotify,2025,01-2025,Q1-2025
2025-01-10,Transfer to Savings,-992.0,-2133.879999999999,BOA_7259,expense,Transfer,Savings,Monthly Transfer,"essential,monthly",Self,Self,2025,01-2025,Q1-2025
2025-01-11,Transfer to Investment,-517.0,-2650.879999999999,BOA_7259,expense,Transfer,Investment,Monthly Investment,"essential,monthly",Self,Self,2025,01-2025,Q1-2025
2025-01-12,Transfer to Credit Card,-1504.0,-4154.879999999999,BOA_7259,expense,Transfer,Credit Card,Payment,"essential,monthly",Self,Self,2025,01-2025,Q1-2025
2025-01-13,ATM Withdrawal,-200.0,-4354.879999999999,BOA_7259,expense,Transfer,Cash,ATM Withdrawal,"essential,monthly",Self,Self,2025,01-2025,Q1-2025
2025-01-14,Grocery Store,-439.0,-4793.879999999999,BOA_7259,expense,Food & Dining,Groceries,Daily Groceries,"essential,monthly",Self,Grocery Store,2025,01-2025,Q1-2025
2025-01-19,Grocery Store,-466.0,-5259.879999999999,BOA_7259,expense,Food & Dining,Groceries,Daily Groceries,"essential,monthly",Self,Grocery Store,2025,01-2025,Q1-2025
2025-01-23,Grocery Store,-478.0,-5737.879999999999,BOA_7259,expense,Food & Dining,Groceries,Daily Groceries,"essential,monthly",Self,Grocery Store,2025,01-2025,Q1-2025
2025-01-30,Grocery Store,-424.0,-6161.879999999999,BOA_7259,expense,Food & Dining,Groceries,Daily Groceries,"essential,monthly",Self,Grocery Store,2025,01-2025,Q1-2025
2025-02-03,Gas Station,-70.0,-6231.879999999999,BOA_7259,expense,Transportation,Fuel,Gasoline,"essential,monthly",Self,Gas Station,2025,02-2025,Q1-2025
2025-02-07,Gas Station,-58.0,-6289.879999999999,BOA_7259,expense,Transportation,Fuel,Gasoline,"essential,monthly",Self,Gas Station,2025,02-2025,Q1-2025
2025-02-09,Gas Station,-48.0,-6337.879999999999,BOA_7259,expense,Transportation,Fuel,Gasoline,"essential,monthly",Self,Gas Station,2025,02-2025,Q1-2025
2025-02-16,Gas Station,-79.0,-6416.879999999999,BOA_7259,expense,Transportation,Fuel,Gasoline,"essential,monthly",Self,Gas Station,2025,02-2025,Q1-2025
2025-02-23,Starbucks,-3.0,-6419.879999999999,BOA_7259,expense,Food & Dining,Coffee,Takeout,"luxury,monthly",Self,Starbucks,2025,02-2025,Q1-2025
2025-02-28,Starbucks,-31.0,-6450.879999999999,BOA_7259,expense,Food & Dining,Coffee,Takeout,"luxury,monthly",Self,Starbucks,2025,02-2025,Q1-2025
2025-03-03,Target,-93.0,-6543.879999999999,BOA_7259,expense,Shopping,Retail,Household Items,"essential,monthly",Self,Target,2025,03-2025,Q1-2025
2025-03-06,Target,-100.0,-6643.879999999999,BOA_7259,expense,Shopping,Retail,Household Items,"essential,monthly",Self,Target,2025,03-2025,Q1-2025
2025-03-12,Target,-98.0,-6741.879999999999,BOA_7259,expense,Shopping,Retail,Household Items,"essential,monthly",Self,Target,2025,03-2025,Q1-2025
2025-03-13,Costco,-250.0,-6991.879999999999,BOA_7259,expense,Food & Dining,Groceries,Bulk Shopping,"essential,monthly",Self,Costco,2025,03-2025,Q1-2025
2025-03-20,Costco,-202.0,-7193.879999999999,BOA_7259,expense,Food & Dining,Groceries,Bulk Shopping,"essential,monthly",Self,Costco,2025,03-2025,Q1-2025
2025-03-26,Costco,-250.0,-7443.879999999999,BOA_7259,expense,Food & Dining,Groceries,Bulk Shopping,"essential,monthly",Self,Costco,2025,03-2025,Q1-2025
2025-04-02,Restaurant,-86.0,-7529.879999999999,BOA_7259,expense,Food & Dining,Dining Out,Casual Dining,"luxury,monthly",Self,Restaurant,2025,04-2025,Q2-2025
2025-04-08,Movie Theater,-74.0,-7603.879999999999,BOA_7259,expense,Entertainment,Movies,Cinema,"luxury,monthly",Self,Movie Theater,2025,04-2025,Q2-2025
2025-04-10,Clothing Store,-124.0,-7727.879999999999,BOA_7259,expense,Shopping,Clothing,Apparel,"luxury,monthly",Self,Clothing Store,2025,04-2025,Q2-2025
2025-04-11,Doctor Visit,-30.0,-7757.879999999999,BOA_7259,expense,Healthcare,Medical,Primary Care,"essential,monthly",Self,Healthcare Provider,2025,04-2025,Q2-2025
2025-04-12,Car Wash,-47.0,-7804.879999999999,BOA_7259,expense,Transportation,Car Maintenance,Cleaning,"essential,monthly",Self,Car Wash,2025,04-2025,Q2-2025
2025-04-13,Oil Change,-29.0,-7833.879999999999,BOA_7259,expense,Transportation,Car Maintenance,Service,"essential,monthly",Self,Car Service,2025,04-2025,Q2-2025
2025-04-19,Transfer from Savings,595.0,-7238.879999999999,BOA_7259,transfer,Transfer,Savings,Emergency Withdrawal,"essential,one-time",Self,Self,2025,04-2025,Q2-2025
2025-05-01,Salary Deposit,8500.0,1261.1200000000008,BOA_7259,income,Income,Salary,Primary Income,"essential,monthly",Employer,Self,2025,05-2025,Q2-2025
2025-05-02,Interest Payment,20.0,1281.1200000000008,BOA_7259,income,Income,Interest,Bank Interest,"essential,monthly",Bank,Self,2025,05-2025,Q2-2025
2025-05-03,Mortgage Payment,-3183.0,-1901.8799999999992,BOA_7259,expense,Housing,Mortgage,Principal & Interest,"essential,monthly",Self,Bank,2025,05-2025,Q2-2025
2025-05-04,Utility Bill,-205.0,-2106.879999999999,BOA_7259,expense,Utilities,Electricity,Monthly Bill,"essential,monthly",Self,Utility Company,2025,05-2025,Q2-2025
2025-05-05,Internet Bill,-72.99,-2179.869999999999,BOA_7259,expense,Utilities,Internet,Monthly Service,"essential,monthly",Self,Internet Provider,2025,05-2025,Q2-2025
2025-05-06,Phone Bill,-88.0,-2267.869999999999,BOA_7259,expense,Utilities,Phone,Monthly Service,"essential,monthly",Self,Phone Company,2025,05-2025,Q2-2025
2025-05-07,Insurance Payment,-348.0,-2615.869999999999,BOA_7259,expense,Insurance,Health Insurance,Monthly Premium,"essential,monthly",Self,Insurance Company,2025,05-2025,Q2-2025
2025-05-08,Netflix Subscription,-2.99,-2618.8599999999988,BOA_7259,expense,Entertainment,Streaming,Video Streaming,"luxury,monthly",Self,Netflix,2025,05-2025,Q2-2025
2025-05-09,Spotify Subscription,-15.99,-2634.8499999999985,BOA_7259,expense,Entertainment,Music,Streaming,"luxury,monthly",Self,Spotify,2025,05-2025,Q2-2025
2025-05-10,Transfer to Savings,-1014.0,-3648.8499999999985,BOA_7259,expense,Transfer,Savings,Monthly Transfer,"essential,monthly",Self,Self,2025,05-2025,Q2-2025
2025-05-11,Transfer to Investment,-518.0,-4166.8499999999985,BOA_7259,expense,Transfer,Investment,Monthly Investment,"essential,monthly",Self,Self,2025,05-2025,Q2-2025
2025-05-12,Transfer to Credit Card,-1483.0,-5649.8499999999985,BOA_7259,expense,Transfer,Credit Card,Payment,"essential,monthly",Self,Self,2025,05-2025,Q2-2025
2025-05-13,ATM Withdrawal,-214.0,-5863.8499999999985,BOA_7259,expense,Transfer,Cash,ATM Withdrawal,"essential,monthly",Self,Self,2025,05-2025,Q2-2025
2025-05-14,Grocery Store,-453.0,-6316.8499999999985,BOA_7259,expense,Food & Dining,Groceries,Daily Groceries,"essential,monthly",Self,Grocery Store,2025,05-2025,Q2-2025
2025-05-17,Grocery Store,-456.0,-6772.8499999999985,BOA_7259,expense,Food & Dining,Groceries,Daily Groceries,"essential,monthly",Self,Grocery Store,2025,05-2025,Q2-2025
2025-05-19,Gas Station,-61.0,-6833.8499999999985,BOA_7259,expense,Transportation,Fuel,Gasoline,"essential,monthly",Self,Gas Station,2025,05-2025,Q2-2025
2025-05-20,Gas Station,-38.0,-6871.8499999999985,BOA_7259,expense,Transportation,Fuel,Gasoline,"essential,monthly",Self,Gas Station,2025,05-2025,Q2-2025
2025-05-27,Gas Station,-39.0,-6910.8499999999985,BOA_7259,expense,Transportation,Fuel,Gasoline,"essential,monthly",Self,Gas Station,2025,05-2025,Q2-2025
2025-06-03,Starbucks,-31.0,-6941.8499999999985,BOA_7259,expense,Food & Dining,Coffee,Takeout,"luxury,monthly",Self,Starbucks,2025,06-2025,Q2-2025
2025-06-08,Starbucks,-14.0,-6955.8499999999985,BOA_7259,expense,Food & Dining,Coffee,Takeout,"luxury,monthly",Self,Starbucks,2025,06-2025,Q2-2025
2025-06-10,Starbucks,-3.0,-6958.8499999999985,BOA_7259,expense,Food & Dining,Coffee,Takeout,"luxury,monthly",Self,Starbucks,2025,06-2025,Q2-2025
2025-06-13,Starbucks,-26.0,-6984.8499999999985,BOA_7259,expense,Food & Dining,Coffee,Takeout,"luxury,monthly",Self,Starbucks,2025,06-2025,Q2-2025
2025-06-15,Target,-109.0,-7093.8499999999985,BOA_7259,expense,Shopping,Retail,Household Items,"essential,monthly",Self,Target,2025,06-2025,Q2-2025
2025-06-18,Target,-106.0,-7199.8499999999985,BOA_7259,expense,Shopping,Retail,Household Items,"essential,monthly",Self,Target,2025,06-2025,Q2-2025
2025-06-25,Costco,-214.0,-7413.8499999999985,BOA_7259,expense,Food & Dining,Groceries,Bulk Shopping,"essential,monthly",Self,Costco,2025,06-2025,Q2-2025
2025-06-29,Costco,-229.0,-7642.8499999999985,BOA_7259,expense,Food & Dining,Groceries,Bulk Shopping,"essential,monthly",Self,Costco,2025,06-2025,Q2-2025
2025-07-03,Costco,-230.0,-7872.8499999999985,BOA_7259,expense,Food & Dining,Groceries,Bulk Shopping,"essential,monthly",Self,Costco,2025,07-2025,Q3-2025
2025-07-05,Costco,-237.0,-8109.8499999999985,BOA_7259,expense,Food & Dining,Groceries,Bulk Shopping,"essential,monthly",Self,Costco,2025,07-2025,Q3-2025
2025-07-10,Restaurant,-75.0,-8184.8499999999985,BOA_7259,expense,Food & Dining,Dining Out,Casual Dining,"luxury,monthly",Self,Restaurant,2025,07-2025,Q3-2025
2025-07-16,Pet Store,-63.0,-8247.849999999999,BOA_7259,expense,Shopping,Pets,Pet Supplies,"essential,monthly",Self,Pet Store,2025,07-2025,Q3-2025
2025-07-20,Doctor Visit,-41.0,-8288.849999999999,BOA_7259,expense,Healthcare,Medical,Primary Care,"essential,monthly",Self,Healthcare Provider,2025,07-2025,Q3-2025
2025-07-23,Car Wash,-20.0,-8308.849999999999,BOA_7259,expense,Transportation,Car Maintenance,Cleaning,"essential,monthly",Self,Car Wash,2025,07-2025,Q3-2025
2025-07-29,Charity Donation,-113.0,-8421.849999999999,BOA_7259,expense,Charity,Donations,Monthly Giving,"essential,monthly",Self,Charity,2025,07-2025,Q3-2025
2025-07-31,Amazon Purchase,-113.0,-8534.849999999999,BOA_7259,expense,Shopping,Online Shopping,Electronics,"luxury,one-time",Self,Amazon,2025,07-2025,Q3-2025
2025-08-01,Home Depot,-118.0,-8652.849999999999,BOA_7259,expense,Shopping,Home Improvement,Hardware,"essential,one-time",Self,Home Depot,2025,08-2025,Q3-2025
2025-08-06,Mother's Day Gift,-120.0,-8772.849999999999,BOA_7259,expense,Shopping,Gifts,Holiday,"luxury,one-time",Self,Retail Store,2025,08-2025,Q3-2025
2025-09-01,Salary Deposit,8500.0,-272.84999999999854,BOA_7259,income,Income,Salary,Primary Income,"essential,monthly",Employer,Self,2025,09-2025,Q3-2025
2025-09-02,Interest Payment,10.0,-262.84999999999854,BOA_7259,income,Income,Interest,Bank Interest,"essential,monthly",Bank,Self,2025,09-2025,Q3-2025
2025-09-03,Mortgage Payment,-3192.0,-3454.8499999999985,BOA_7259,expense,Housing,Mortgage,Principal & Interest,"essential,monthly",Self,Bank,2025,09-2025,Q3-2025
2025-09-04,Utility Bill,-201.0,-3655.8499999999985,BOA_7259,expense,Utilities,Electricity,Monthly Bill,"essential,monthly",Self,Utility Company,2025,09-2025,Q3-2025
2025-09-05,Internet Bill,-80.99,-3736.8399999999983,BOA_7259,expense,Utilities,Internet,Monthly Service,"essential,monthly",Self,Internet Provider,2025,09-2025,Q3-2025
2025-09-06,Phone Bill,-97.0,-3833.8399999999983,BOA_7259,expense,Utilities,Phone,Monthly Service,"essential,monthly",Self,Phone Company,2025,09-2025,Q3-2025
2025-09-07,Insurance Payment,-365.0,-4198.839999999998,BOA_7259,expense,Insurance,Health Insurance,Monthly Premium,"essential,monthly",Self,Insurance Company,2025,09-2025,Q3-2025
2025-09-08,Netflix Subscription,-25.990000000000002,-4224.829999999998,BOA_7259,expense,Entertainment,Streaming,Video Streaming,"luxury,monthly",Self,Netflix,2025,09-2025,Q3-2025
2025-09-09,Spotify Subscription,-29.990000000000002,-4254.819999999998,BOA_7259,expense,Entertainment,Music,Streaming,"luxury,monthly",Self,Spotify,2025,09-2025,Q3-2025
2025-09-10,Transfer to Savings,-981.0,-5235.819999999998,BOA_7259,expense,Transfer,Savings,Monthly Transfer,"essential,monthly",Self,Self,2025,09-2025,Q3-2025
2025-09-11,Transfer to Investment,-493.0,-5728.819999999998,BOA_7259,expense,Transfer,Investment,Monthly Investment,"essential,monthly",Self,Self,2025,09-2025,Q3-2025
2025-09-12,Transfer to Credit Card,-1505.0,-7233.819999999998,BOA_7259,expense,Transfer,Credit Card,Payment,"essential,monthly",Self,Self,2025,09-2025,Q3-2025
2025-09-13,ATM Withdrawal,-192.0,-7425.819999999998,BOA_7259,expense,Transfer,Cash,ATM Withdrawal,"essential,monthly",Self,Self,2025,09-2025,Q3-2025
2025-09-14,Grocery Store,-457.0,-7882.819999999998,BOA_7259,expense,Food & Dining,Groceries,Daily Groceries,"essential,monthly",Self,Grocery Store,2025,09-2025,Q3-2025
2025-09-15,Grocery Store,-436.0,-8318.819999999998,BOA_7259,expense,Food & Dining,Groceries,Daily Groceries,"essential,monthly",Self,Grocery Store,2025,09-2025,Q3-2025
2025-09-21,Grocery Store,-466.0,-8784.819999999998,BOA_7259,expense,Food & Dining,Groceries,Daily Groceries,"essential,monthly",Self,Grocery Store,2025,09-2025,Q3-2025
2025-09-27,Grocery Store,-440.0,-9224.819999999998,BOA_7259,expense,Food & Dining,Groceries,Daily Groceries,"essential,monthly",Self,Grocery Store,2025,09-2025,Q3-2025
2025-09-28,Gas Station,-87.0,-9311.819999999998,BOA_7259,expense,Transportation,Fuel,Gasoline,"essential,monthly",Self,Gas Station,2025,09-2025,Q3-2025
2025-09-30,Gas Station,-73.0,-9384.819999999998,BOA_7259,expense,Transportation,Fuel,Gasoline,"essential,monthly",Self,Gas Station,2025,09-2025,Q3-2025
2025-10-03,Gas Station,-42.0,-9426.819999999998,BOA_7259,expense,Transportation,Fuel,Gasoline,"essential,monthly",Self,Gas Station,2025,10-2025,Q4-2025
2025-10-09,Gas Station,-73.0,-9499.819999999998,BOA_7259,expense,Transportation,Fuel,Gasoline,"essential,monthly",Self,Gas Station,2025,10-2025,Q4-2025
2025-10-14,Starbucks,-20.0,-9519.819999999998,BOA_7259,expense,Food & Dining,Coffee,Takeout,"luxury,monthly",Self,Starbucks,2025,10-2025,Q4-2025
2025-10-15,Starbucks,3.0,-9516.819999999998,BOA_7259,expense,Food & Dining,Coffee,Takeout,"luxury,monthly",Self,Starbucks,2025,10-2025,Q4-2025
2025-10-21,Starbucks,-15.0,-9531.819999999998,BOA_7259,expense,Food & Dining,Coffee,Takeout,"luxury,monthly",Self,Starbucks,2025,10-2025,Q4-2025
2025-10-26,Starbucks,-36.0,-9567.819999999998,BOA_7259,expense,Food & Dining,Coffee,Takeout,"luxury,monthly",Self,Starbucks,2025,10-2025,Q4-2025
2025-10-28,Target,-84.0,-9651.819999999998,BOA_7259,expense,Shopping,Retail,Household Items,"essential,monthly",Self,Target,2025,10-2025,Q4-2025
2025-11-03,Target,-78.0,-9729.819999999998,BOA_7259,expense,Shopping,Retail,Household Items,"essential,monthly",Self,Target,2025,11-2025,Q4-2025
2025-11-04,Costco,-215.0,-9944.819999999998,BOA_7259,expense,Food & Dining,Groceries,Bulk Shopping,"essential,monthly",Self,Costco,2025,11-2025,Q4-2025
2025-11-11,Costco,-206.0,-10150.819999999998,BOA_7259,expense,Food & Dining,Groceries,Bulk Shopping,"essential,monthly",Self,Costco,2025,11-2025,Q4-2025
2025-11-16,Restaurant,-109.0,-10259.819999999998,BOA_7259,expense,Food & Dining,Dining Out,Casual Dining,"luxury,monthly",Self,Restaurant,2025,11-2025,Q4-2025
2025-11-24,Clothing Store,-119.0,-10378.819999999998,BOA_7259,expense,Shopping,Clothing,Apparel,"luxury,monthly",Self,Clothing Store,2025,11-2025,Q4-2025
2025-11-27,Doctor Visit,-69.0,-10447.819999999998,BOA_7259,expense,Healthcare,Medical,Primary Care,"essential,monthly",Self,Healthcare Provider,2025,11-2025,Q4-2025
2025-12-01,Pharmacy,-49.0,-10496.819999999998,BOA_7259,expense,Healthcare,Prescriptions,Medication,"essential,monthly",Self,Pharmacy,2025,12-2025,Q4-2025
2025-12-10,Oil Change,-41.0,-10537.819999999998,BOA_7259,expense,Transportation,Car Maintenance,Service,"essential,monthly",Self,Car Service,2025,12-2025,Q4-2025
2025-12-16,Amazon Purchase,-103.0,-10640.819999999998,BOA_7259,expense,Shopping,Online Shopping,Electronics,"luxury,one-time",Self,Amazon,2025,12-2025,Q4-2025
2025-12-25,Back to School Shopping,-300.0,-10940.819999999998,BOA_7259,expense,Education,School Supplies,Annual,"essential,annual",Self,Retail Store,2025,12-2025,Q4-2025
2025-12-26,Transfer from Savings,542.0,-10398.819999999998,BOA_7259,transfer,Transfer,Savings,Emergency Withdrawal,"essential,one-time",Self,Self,2025,12-2025,Q4-2025
2026-01-01,Salary Deposit,8500.0,-1898.819999999998,BOA_7259,income,Income,Salary,Primary Income,"essential,monthly",Employer,Self,2026,01-2026,Q1-2026
2026-01-02,Interest Payment,16.0,-1882.819999999998,BOA_7259,income,Income,Interest,Bank Interest,"essential,monthly",Bank,Self,2026,01-2026,Q1-2026
2026-01-03,Mortgage Payment,-3185.0,-5067.819999999998,BOA_7259,expense,Housing,Mortgage,Principal & Interest,"essential,monthly",Self,Bank,2026,01-2026,Q1-2026
2026-01-04,Utility Bill,-175.0,-5242.819999999998,BOA_7259,expense,Utilities,Electricity,Monthly Bill,"essential,monthly",Self,Utility Company,2026,01-2026,Q1-2026
2026-01-05,Internet Bill,-91.99,-5334.809999999998,BOA_7259,expense,Utilities,Internet,Monthly Service,"essential,monthly",Self,Internet Provider,2026,01-2026,Q1-2026
2026-01-06,Phone Bill,-79.0,-5413.809999999998,BOA_7259,expense,Utilities,Phone,Monthly Service,"essential,monthly",Self,Phone Company,2026,01-2026,Q1-2026
2026-01-07,Insurance Payment,-335.0,-5748.809999999998,BOA_7259,expense,Insurance,Health Insurance,Monthly Premium,"essential,monthly",Self,Insurance Company,2026,01-2026,Q1-2026
2026-01-08,Netflix Subscription,-20.990000000000002,-5769.799999999997,BOA_7259,expense,Entertainment,Streaming,Video Streaming,"luxury,monthly",Self,Netflix,2026,01-2026,Q1-2026
2026-01-09,Spotify Subscription,-19.990000000000002,-5789.789999999997,BOA_7259,expense,Entertainment,Music,Streaming,"luxury,monthly",Self,Spotify,2026,01-2026,Q1-2026
2026-01-10,Transfer to Savings,-1012.0,-6801.789999999997,BOA_7259,expense,Transfer,Savings,Monthly Transfer,"essential,monthly",Self,Self,2026,01-2026,Q1-2026
2026-01-11,Transfer to Investment,-482.0,-7283.789999999997,BOA_7259,expense,Transfer,Investment,Monthly Investment,"essential,monthly",Self,Self,2026,01-2026,Q1-2026
2026-01-12,Transfer to Credit Card,-1498.0,-8781.789999999997,BOA_7259,expense,Transfer,Credit Card,Payment,"essential,monthly",Self,Self,2026,01-2026,Q1-2026
2026-01-13,ATM Withdrawal,-202.0,-8983.789999999997,BOA_7259,expense,Transfer,Cash,ATM Withdrawal,"essential,monthly",Self,Self,2026,01-2026,Q1-2026
2026-01-14,Grocery Store,-425.0,-9408.789999999997,BOA_7259,expense,Food & Dining,Groceries,Daily Groceries,"essential,monthly",Self,Grocery Store,2026,01-2026,Q1-2026
2026-01-17,Grocery Store,-424.0,-9832.789999999997,BOA_7259,expense,Food & Dining,Groceries,Daily Groceries,"essential,monthly",Self,Grocery Store,2026,01-2026,Q1-2026
2026-01-23,Gas Station,-84.0,-9916.789999999997,BOA_7259,expense,Transportation,Fuel,Gasoline,"essential,monthly",Self,Gas Station,2026,01-2026,Q1-2026
2026-01-27,Gas Station,-67.0,-9983.789999999997,BOA_7259,expense,Transportation,Fuel,Gasoline,"essential,monthly",Self,Gas Station,2026,01-2026,Q1-2026
2026-02-02,Gas Station,-44.0,-10027.789999999997,BOA_7259,expense,Transportation,Fuel,Gasoline,"essential,monthly",Self,Gas Station,2026,02-2026,Q1-2026
2026-02-08,Starbucks,-20.0,-10047.789999999997,BOA_7259,expense,Food & Dining,Coffee,Takeout,"luxury,monthly",Self,Starbucks,2026,02-2026,Q1-2026
2026-02-15,Starbucks,-11.0,-10058.789999999997,BOA_7259,expense,Food & Dining,Coffee,Takeout,"luxury,monthly",Self,Starbucks,2026,02-2026,Q1-2026
2026-02-20,Starbucks,8.0,-10050.789999999997,BOA_7259,expense,Food & Dining,Coffee,Takeout,"luxury,monthly",Self,Starbucks,2026,02-2026,Q1-2026
2026-02-24,Target,-96.0,-10146.789999999997,BOA_7259,expense,Shopping,Retail,Household Items,"essential,monthly",Self,Target,2026,02-2026,Q1-2026
2026-03-03,Target,-86.0,-10232.789999999997,BOA_7259,expense,Shopping,Retail,Household Items,"essential,monthly",Self,Target,2026,03-2026,Q1-2026
2026-03-06,Target,-73.0,-10305.789999999997,BOA_7259,expense,Shopping,Retail,Household Items,"essential,monthly",Self,Target,2026,03-2026,Q1-2026
2026-03-10,Target,-61.0,-10366.789999999997,BOA_7259,expense,Shopping,Retail,Household Items,"essential,monthly",Self,Target,2026,03-2026,Q1-2026
2026-03-16,Costco,-234.0,-10600.789999999997,BOA_7259,expense,Food & Dining,Groceries,Bulk Shopping,"essential,monthly",Self,Costco,2026,03-2026,Q1-2026
2026-03-18,Costco,-232.0,-10832.789999999997,BOA_7259,expense,Food & Dining,Groceries,Bulk Shopping,"essential,monthly",Self,Costco,2026,03-2026,Q1-2026
2026-03-21,Restaurant,-75.0,-10907.789999999997,BOA_7259,expense,Food & Dining,Dining Out,Casual Dining,"luxury,monthly",Self,Restaurant,2026,03-2026,Q1-2026
2026-03-22,Movie Theater,-72.0,-10979.789999999997,BOA_7259,expense,Entertainment,Movies,Cinema,"luxury,monthly",Self,Movie Theater,2026,03-2026,Q1-2026
2026-03-26,Clothing Store,-104.0,-11083.789999999997,BOA_7259,expense,Shopping,Clothing,Apparel,"luxury,monthly",Self,Clothing Store,2026,03-2026,Q1-2026
2026-03-30,Doctor Visit,-36.0,-11119.789999999997,BOA_7259,expense,Healthcare,Medical,Primary Care,"essential,monthly",Self,Healthcare Provider,2026,03-2026,Q1-2026
2026-04-02,Car Wash,-3.0,-11122.789999999997,BOA_7259,expense,Transportation,Car Maintenance,Cleaning,"essential,monthly",Self,Car Wash,2026,04-2026,Q2-2026
2026-04-11,Oil Change,-48.0,-11170.789999999997,BOA_7259,expense,Transportation,Car Maintenance,Service,"essential,monthly",Self,Car Service,2026,04-2026,Q2-2026
2026-04-13,Charity Donation,-107.0,-11277.789999999997,BOA_7259,expense,Charity,Donations,Monthly Giving,"essential,monthly",Self,Charity,2026,04-2026,Q2-2026
2026-04-19,Amazon Purchase,-118.0,-11395.789999999997,BOA_7259,expense,Shopping,Online Shopping,Electronics,"luxury,one-time",Self,Amazon,2026,04-2026,Q2-2026
2026-05-02,Transfer from Savings,498.0,-10897.789999999997,BOA_7259,transfer,Transfer,Savings,Emergency Withdrawal,"essential,one-time",Self,Self,2026,05-2026,Q2-2026
2026-06-01,Salary Deposit,8500.0,-2397.7899999999972,BOA_7259,income,Income,Salary,Primary Income,"essential,monthly",Employer,Self,2026,06-2026,Q2-2026
2026-06-02,Interest Payment,16.0,-2381.7899999999972,BOA_7259,income,Income,Interest,Bank Interest,"essential,monthly",Bank,Self,2026,06-2026,Q2-2026
2026-06-03,Mortgage Payment,-3215.0,-5596.789999999997,BOA_7259,expense,Housing,Mortgage,Principal & Interest,"essential,monthly",Self,Bank,2026,06-2026,Q2-2026
2026-06-04,Utility Bill,-168.0,-5764.789999999997,BOA_7259,expense,Utilities,Electricity,Monthly Bill,"essential,monthly",Self,Utility Company,2026,06-2026,Q2-2026
2026-06-05,Internet Bill,-108.99,-5873.779999999997,BOA_7259,expense,Utilities,Internet,Monthly Service,"essential,monthly",Self,Internet Provider,2026,06-2026,Q2-2026
2026-06-06,Phone Bill,-110.0,-5983.779999999997,BOA_7259,expense,Utilities,Phone,Monthly Service,"essential,monthly",Self,Phone Company,2026,06-2026,Q2-2026
2026-06-07,Insurance Payment,-340.0,-6323.779999999997,BOA_7259,expense,Insurance,Health Insurance,Monthly Premium,"essential,monthly",Self,Insurance Company,2026,06-2026,Q2-2026
2026-06-08,Netflix Subscription,-13.99,-6337.769999999997,BOA_7259,expense,Entertainment,Streaming,Video Streaming,"luxury,monthly",Self,Netflix,2026,06-2026,Q2-2026
2026-06-09,Spotify Subscription,-0.9900000000000002,-6338.759999999997,BOA_7259,expense,Entertainment,Music,Streaming,"luxury,monthly",Self,Spotify,2026,06-2026,Q2-2026
2026-06-10,Transfer to Savings,-1016.0,-7354.759999999997,BOA_7259,expense,Transfer,Savings,Monthly Transfer,"essential,monthly",Self,Self,2026,06-2026,Q2-2026
2026-06-11,Transfer to Investment,-515.0,-7869.759999999997,BOA_7259,expense,Transfer,Investment,Monthly Investment,"essential,monthly",Self,Self,2026,06-2026,Q2-2026
2026-06-12,Transfer to Credit Card,-1507.0,-9376.759999999997,BOA_7259,expense,Transfer,Credit Card,Payment,"essential,monthly",Self,Self,2026,06-2026,Q2-2026
2026-06-13,ATM Withdrawal,-207.0,-9583.759999999997,BOA_7259,expense,Transfer,Cash,ATM Withdrawal,"essential,monthly",Self,Self,2026,06-2026,Q2-2026
2026-06-14,Grocery Store,-428.0,-10011.759999999997,BOA_7259,expense,Food & Dining,Groceries,Daily Groceries,"essential,monthly",Self,Grocery Store,2026,06-2026,Q2-2026
2026-06-16,Grocery Store,-442.0,-10453.759999999997,BOA_7259,expense,Food & Dining,Groceries,Daily Groceries,"essential,monthly",Self,Grocery Store,2026,06-2026,Q2-2026
2026-06-20,Grocery Store,-439.0,-10892.759999999997,BOA_7259,expense,Food & Dining,Groceries,Daily Groceries,"essential,monthly",Self,Grocery Store,2026,06-2026,Q2-2026
2026-06-27,Gas Station,-64.0,-10956.759999999997,BOA_7259,expense,Transportation,Fuel,Gasoline,"essential,monthly",Self,Gas Station,2026,06-2026,Q2-2026
2026-06-29,Gas Station,-93.0,-11049.759999999997,BOA_7259,expense,Transportation,Fuel,Gasoline,"essential,monthly",Self,Gas Station,2026,06-2026,Q2-2026
2026-07-03,Starbucks,-22.0,-11071.759999999997,BOA_7259,expense,Food & Dining,Coffee,Takeout,"luxury,monthly",Self,Starbucks,2026,07-2026,Q3-2026
2026-07-05,Starbucks,-1.0,-11072.759999999997,BOA_7259,expense,Food & Dining,Coffee,Takeout,"luxury,monthly",Self,Starbucks,2026,07-2026,Q3-2026
2026-07-11,Starbucks,13.0,-11059.759999999997,BOA_7259,expense,Food & Dining,Coffee,Takeout,"luxury,monthly",Self,Starbucks,2026,07-2026,Q3-2026
2026-07-14,Target,-98.0,-11157.759999999997,BOA_7259,expense,Shopping,Retail,Household Items,"essential,monthly",Self,Target,2026,07-2026,Q3-2026
2026-07-20,Target,-115.0,-11272.759999999997,BOA_7259,expense,Shopping,Retail,Household Items,"essential,monthly",Self,Target,2026,07-2026,Q3-2026
2026-07-24,Target,-95.0,-11367.759999999997,BOA_7259,expense,Shopping,Retail,Household Items,"essential,monthly",Self,Target,2026,07-2026,Q3-2026
2026-07-31,Costco,-245.0,-11612.759999999997,BOA_7259,expense,Food & Dining,Groceries,Bulk Shopping,"essential,monthly",Self,Costco,2026,07-2026,Q3-2026
2026-08-06,Costco,-201.0,-11813.759999999997,BOA_7259,expense,Food & Dining,Groceries,Bulk Shopping,"essential,monthly",Self,Costco,2026,08-2026,Q3-2026
2026-08-09,Restaurant,-98.0,-11911.759999999997,BOA_7259,expense,Food & Dining,Dining Out,Casual Dining,"luxury,monthly",Self,Restaurant,2026,08-2026,Q3-2026
2026-08-13,Clothing Store,-107.0,-12018.759999999997,BOA_7259,expense,Shopping,Clothing,Apparel,"luxury,monthly",Self,Clothing Store,2026,08-2026,Q3-2026
2026-08-15,Pet Store,-49.0,-12067.759999999997,BOA_7259,expense,Shopping,Pets,Pet Supplies,"essential,monthly",Self,Pet Store,2026,08-2026,Q3-2026
2026-08-16,Doctor Visit,-25.0,-12092.759999999997,BOA_7259,expense,Healthcare,Medical,Primary Care,"essential,monthly",Self,Healthcare Provider,2026,08-2026,Q3-2026
2026-08-23,Oil Change,-61.0,-12153.759999999997,BOA_7259,expense,Transportation,Car Maintenance,Service,"essential,monthly",Self,Car Service,2026,08-2026,Q3-2026
2026-08-26,Charity Donation,-93.0,-12246.759999999997,BOA_7259,expense,Charity,Donations,Monthly Giving,"essential,monthly",Self,Charity,2026,08-2026,Q3-2026
2026-08-29,Father's Day Gift,-100.0,-12346.759999999997,BOA_7259,expense,Shopping,Gifts,Holiday,"luxury,one-time",Self,Retail Store,2026,08-2026,Q3-2026
2026-08-30,Transfer from Savings,424.0,-11922.759999999997,BOA_7259,transfer,Transfer,Savings,Emergency Withdrawal,"essential,one-time",Self,Self,2026,08-2026,Q3-2026
2026-09-01,Salary Deposit,8500.0,-3422.7599999999966,BOA_7259,income,Income,Salary,Primary Income,"essential,monthly",Employer,Self,2026,09-2026,Q3-2026
2026-09-02,Interest Payment,12.0,-3410.7599999999966,BOA_7259,income,Income,Interest,Bank Interest,"essential,monthly",Bank,Self,2026,09-2026,Q3-2026
2026-09-03,Mortgage Payment,-3211.0,-6621.759999999997,BOA_7259,expense,Housing,Mortgage,Principal & Interest,"essential,monthly",Self,Bank,2026,09-2026,Q3-2026
2026-09-04,Utility Bill,-181.0,-6802.759999999997,BOA_7259,expense,Utilities,Electricity,Monthly Bill,"essential,monthly",Self,Utility Company,2026,09-2026,Q3-2026
2026-09-05,Internet Bill,-76.99,-6879.749999999996,BOA_7259,expense,Utilities,Internet,Monthly Service,"essential,monthly",Self,Internet Provider,2026,09-2026,Q3-2026
2026-09-06,Phone Bill,-99.0,-6978.749999999996,BOA_7259,expense,Utilities,Phone,Monthly Service,"essential,monthly",Self,Phone Company,2026,09-2026,Q3-2026
2026-09-07,Insurance Payment,-357.0,-7335.749999999996,BOA_7259,expense,Insurance,Health Insurance,Monthly Premium,"essential,monthly",Self,Insurance Company,2026,09-2026,Q3-2026
2026-09-08,Netflix Subscription,-3.99,-7339.739999999996,BOA_7259,expense,Entertainment,Streaming,Video Streaming,"luxury,monthly",Self,Netflix,2026,09-2026,Q3-2026
2026-09-09,Spotify Subscription,4.01,-7335.729999999996,BOA_7259,expense,Entertainment,Music,Streaming,"luxury,monthly",Self,Spotify,2026,09-2026,Q3-2026
2026-09-10,Transfer to Savings,-994.0,-8329.729999999996,BOA_7259,expense,Transfer,Savings,Monthly Transfer,"essential,monthly",Self,Self,2026,09-2026,Q3-2026
2026-09-11,Transfer to Investment,-492.0,-8821.729999999996,BOA_7259,expense,Transfer,Investment,Monthly Investment,"essential,monthly",Self,Self,2026,09-2026,Q3-2026
2026-09-12,Transfer to Credit Card,-1495.0,-10316.729999999996,BOA_7259,expense,Transfer,Credit Card,Payment,"essential,monthly",Self,Self,2026,09-2026,Q3-2026
2026-09-13,ATM Withdrawal,-194.0,-10510.729999999996,BOA_7259,expense,Transfer,Cash,ATM Withdrawal,"essential,monthly",Self,Self,2026,09-2026,Q3-2026
2026-09-14,Grocery Store,-426.0,-10936.729999999996,BOA_7259,expense,Food & Dining,Groceries,Daily Groceries,"essential,monthly",Self,Grocery Store,2026,09-2026,Q3-2026
2026-09-16,Grocery Store,-465.0,-11401.729999999996,BOA_7259,expense,Food & Dining,Groceries,Daily Groceries,"essential,monthly",Self,Grocery Store,2026,09-2026,Q3-2026
2026-09-23,Gas Station,-70.0,-11471.729999999996,BOA_7259,expense,Transportation,Fuel,Gasoline,"essential,monthly",Self,Gas Station,2026,09-2026,Q3-2026
2026-09-24,Gas Station,-94.0,-11565.729999999996,BOA_7259,expense,Transportation,Fuel,Gasoline,"essential,monthly",Self,Gas Station,2026,09-2026,Q3-2026
2026-09-27,Starbucks,19.0,-11546.729999999996,BOA_7259,expense,Food & Dining,Coffee,Takeout,"luxury,monthly",Self,Starbucks,2026,09-2026,Q3-2026
2026-10-01,Starbucks,-34.0,-11580.729999999996,BOA_7259,expense,Food & Dining,Coffee,Takeout,"luxury,monthly",Self,Starbucks,2026,10-2026,Q4-2026
2026-10-02,Starbucks,-19.0,-11599.729999999996,BOA_7259,expense,Food & Dining,Coffee,Takeout,"luxury,monthly",Self,Starbucks,2026,10-2026,Q4-2026
2026-10-08,Starbucks,4.0,-11595.729999999996,BOA_7259,expense,Food & Dining,Coffee,Takeout,"luxury,monthly",Self,Starbucks,2026,10-2026,Q4-2026
2026-10-11,Target,-107.0,-11702.729999999996,BOA_7259,expense,Shopping,Retail,Household Items,"essential,monthly",Self,Target,2026,10-2026,Q4-2026
2026-10-16,Target,-81.0,-11783.729999999996,BOA_7259,expense,Shopping,Retail,Household Items,"essential,monthly",Self,Target,2026,10-2026,Q4-2026
2026-10-20,Costco,-193.0,-11976.729999999996,BOA_7259,expense,Food & Dining,Groceries,Bulk Shopping,"essential,monthly",Self,Costco,2026,10-2026,Q4-2026
2026-10-23,Costco,-213.0,-12189.729999999996,BOA_7259,expense,Food & Dining,Groceries,Bulk Shopping,"essential,monthly",Self,Costco,2026,10-2026,Q4-2026
2026-10-24,Costco,-231.0,-12420.729999999996,BOA_7259,expense,Food & Dining,Groceries,Bulk Shopping,"essential,monthly",Self,Costco,2026,10-2026,Q4-2026
2026-10-26,Clothing Store,-114.0,-12534.729999999996,BOA_7259,expense,Shopping,Clothing,Apparel,"luxury,monthly",Self,Clothing Store,2026,10-2026,Q4-2026
2026-10-31,Pet Store,-35.0,-12569.729999999996,BOA_7259,expense,Shopping,Pets,Pet Supplies,"essential,monthly",Self,Pet Store,2026,10-2026,Q4-2026
2026-11-01,Doctor Visit,-51.0,-12620.729999999996,BOA_7259,expense,Healthcare,Medical,Primary Care,"essential,monthly",Self,Healthcare Provider,2026,11-2026,Q4-2026
2026-11-04,Charity Donation,-86.0,-12706.729999999996,BOA_7259,expense,Charity,Donations,Monthly Giving,"essential,monthly",Self,Charity,2026,11-2026,Q4-2026
2026-11-11,Back to School Shopping,-300.0,-13006.729999999996,BOA_7259,expense,Education,School Supplies,Annual,"essential,annual",Self,Retail Store,2026,11-2026,Q4-2026
2026-12-01,Salary Deposit,8500.0,-4506.729999999996,BOA_7259,income,Income,Salary,Primary Income,"essential,monthly",Employer,Self,2026,12-2026,Q4-2026
2026-12-02,Interest Payment,10.0,-4496.729999999996,BOA_7259,income,Income,Interest,Bank Interest,"essential,monthly",Bank,Self,2026,12-2026,Q4-2026
2026-12-03,Mortgage Payment,-3181.0,-7677.729999999996,BOA_7259,expense,Housing,Mortgage,Principal & Interest,"essential,monthly",Self,Bank,2026,12-2026,Q4-2026
2026-12-04,Utility Bill,-183.0,-7860.729999999996,BOA_7259,expense,Utilities,Electricity,Monthly Bill,"essential,monthly",Self,Utility Company,2026,12-2026,Q4-2026
2026-12-05,Internet Bill,-86.99,-7947.719999999996,BOA_7259,expense,Utilities,Internet,Monthly Service,"essential,monthly",Self,Internet Provider,2026,12-2026,Q4-2026
2026-12-06,Phone Bill,-111.0,-8058.719999999996,BOA_7259,expense,Utilities,Phone,Monthly Service,"essential,monthly",Self,Phone Company,2026,12-2026,Q4-2026
2026-12-07,Insurance Payment,-332.0,-8390.719999999996,BOA_7259,expense,Insurance,Health Insurance,Monthly Premium,"essential,monthly",Self,Insurance Company,2026,12-2026,Q4-2026
2026-12-08,Netflix Subscription,-34.99,-8425.709999999995,BOA_7259,expense,Entertainment,Streaming,Video Streaming,"luxury,monthly",Self,Netflix,2026,12-2026,Q4-2026
2026-12-09,Spotify Subscription,-23.990000000000002,-8449.699999999995,BOA_7259,expense,Entertainment,Music,Streaming,"luxury,monthly",Self,Spotify,2026,12-2026,Q4-2026
2026-12-10,Transfer to Savings,-1001.0,-9450.699999999995,BOA_7259,expense,Transfer,Savings,Monthly Transfer,"essential,monthly",Self,Self,2026,12-2026,Q4-2026
2026-12-11,Transfer to Investment,-506.0,-9956.699999999995,BOA_7259,expense,Transfer,Investment,Monthly Investment,"essential,monthly",Self,Self,2026,12-2026,Q4-2026
2026-12-12,Transfer to Credit Card,-1505.0,-11461.699999999995,BOA_7259,expense,Transfer,Credit Card,Payment,"essential,monthly",Self,Self,2026,12-2026,Q4-2026
2026-12-13,ATM Withdrawal,-194.0,-11655.699999999995,BOA_7259,expense,Transfer,Cash,ATM Withdrawal,"essential,monthly",Self,Self,2026,12-2026,Q4-2026
2026-12-14,Grocery Store,-440.0,-12095.699999999995,BOA_7259,expense,Food & Dining,Groceries,Daily Groceries,"essential,monthly",Self,Grocery Store,2026,12-2026,Q4-2026
2026-12-19,Grocery Store,-473.0,-12568.699999999995,BOA_7259,expense,Food & Dining,Groceries,Daily Groceries,"essential,monthly",Self,Grocery Store,2026,12-2026,Q4-2026
2026-12-25,Grocery Store,-457.0,-13025.699999999995,BOA_7259,expense,Food & Dining,Groceries,Daily Groceries,"essential,monthly",Self,Grocery Store,2026,12-2026,Q4-2026
2026-12-29,Grocery Store,-428.0,-13453.699999999995,BOA_7259,expense,Food & Dining,Groceries,Daily Groceries,"essential,monthly",Self,Grocery Store,2026,12-2026,Q4-2026
2027-01-04,Gas Station,-67.0,-13520.699999999995,BOA_7259,expense,Transportation,Fuel,Gasoline,"essential,monthly",Self,Gas Station,2027,01-2027,Q1-2027
2027-01-11,Gas Station,-61.0,-13581.699999999995,BOA_7259,expense,Transportation,Fuel,Gasoline,"essential,monthly",Self,Gas Station,2027,01-2027,Q1-2027
2027-01-16,Gas Station,-87.0,-13668.699999999995,BOA_7259,expense,Transportation,Fuel,Gasoline,"essential,monthly",Self,Gas Station,2027,01-2027,Q1-2027
2027-01-17,Gas Station,-45.0,-13713.699999999995,BOA_7259,expense,Transportation,Fuel,Gasoline,"essential,monthly",Self,Gas Station,2027,01-2027,Q1-2027
2027-01-22,Starbucks,-11.0,-13724.699999999995,BOA_7259,expense,Food & Dining,Coffee,Takeout,"luxury,monthly",Self,Starbucks,2027,01-2027,Q1-2027
2027-01-26,Starbucks,2.0,-13722.699999999995,BOA_7259,expense,Food & Dining,Coffee,Takeout,"luxury,monthly",Self,Starbucks,2027,01-2027,Q1-2027
2027-01-27,Starbucks,14.0,-13708.699999999995,BOA_7259,expense,Food & Dining,Coffee,Takeout,"luxury,monthly",Self,Starbucks,2027,01-2027,Q1-2027
2027-02-03,Target,-89.0,-13797.699999999995,BOA_7259,expense,Shopping,Retail,Household Items,"essential,monthly",Self,Target,2027,02-2027,Q1-2027
2027-02-06,Target,-90.0,-13887.699999999995,BOA_7259,expense,Shopping,Retail,Household Items,"essential,monthly",Self,Target,2027,02-2027,Q1-2027
2027-02-11,Target,-85.0,-13972.699999999995,BOA_7259,expense,Shopping,Retail,Household Items,"essential,monthly",Self,Target,2027,02-2027,Q1-2027
2027-02-12,Costco,-214.0,-14186.699999999995,BOA_7259,expense,Food & Dining,Groceries,Bulk Shopping,"essential,monthly",Self,Costco,2027,02-2027,Q1-2027
2027-02-18,Costco,-224.0,-14410.699999999995,BOA_7259,expense,Food & Dining,Groceries,Bulk Shopping,"essential,monthly",Self,Costco,2027,02-2027,Q1-2027
2027-02-25,Restaurant,-88.0,-14498.699999999995,BOA_7259,expense,Food & Dining,Dining Out,Casual Dining,"luxury,monthly",Self,Restaurant,2027,02-2027,Q1-2027
2027-03-02,Movie Theater,-72.0,-14570.699999999995,BOA_7259,expense,Entertainment,Movies,Cinema,"luxury,monthly",Self,Movie Theater,2027,03-2027,Q1-2027
2027-03-05,Clothing Store,-138.0,-14708.699999999995,BOA_7259,expense,Shopping,Clothing,Apparel,"luxury,monthly",Self,Clothing Store,2027,03-2027,Q1-2027
2027-03-14,Pet Store,-24.0,-14732.699999999995,BOA_7259,expense,Shopping,Pets,Pet Supplies,"essential,monthly",Self,Pet Store,2027,03-2027,Q1-2027
2027-03-19,Doctor Visit,-32.0,-14764.699999999995,BOA_7259,expense,Healthcare,Medical,Primary Care,"essential,monthly",Self,Healthcare Provider,2027,03-2027,Q1-2027
2027-03-27,Oil Change,-36.0,-14800.699999999995,BOA_7259,expense,Transportation,Car Maintenance,Service,"essential,monthly",Self,Car Service,2027,03-2027,Q1-2027
2027-03-30,Charity Donation,-108.0,-14908.699999999995,BOA_7259,expense,Charity,Donations,Monthly Giving,"essential,monthly",Self,Charity,2027,03-2027,Q1-2027
2027-03-31,Christmas Gifts,-500.0,-15408.699999999995,BOA_7259,expense,Shopping,Gifts,Holiday,"luxury,annual",Self,Retail Store,2027,03-2027,Q1-2027
2027-04-01,Transfer from Savings,466.0,-14942.699999999995,BOA_7259,transfer,Transfer,Savings,Emergency Withdrawal,"essential,one-time",Self,Self,2027,04-2027,Q2-2027
2027-05-01,Salary Deposit,8500.0,-6442.699999999995,BOA_7259,income,Income,Salary,Primary Income,"essential,monthly",Employer,Self,2027,05-2027,Q2-2027
2027-05-02,Interest Payment,10.0,-6432.699999999995,BOA_7259,income,Income,Interest,Bank Interest,"essential,monthly",Bank,Self,2027,05-2027,Q2-2027
2027-05-03,Mortgage Payment,-3219.0,-9651.699999999995,BOA_7259,expense,Housing,Mortgage,Principal & Interest,"essential,monthly",Self,Bank,2027,05-2027,Q2-2027
2027-05-04,Utility Bill,-169.0,-9820.699999999995,BOA_7259,expense,Utilities,Electricity,Monthly Bill,"essential,monthly",Self,Utility Company,2027,05-2027,Q2-2027
2027-05-05,Internet Bill,-73.99,-9894.689999999995,BOA_7259,expense,Utilities,Internet,Monthly Service,"essential,monthly",Self,Internet Provider,2027,05-2027,Q2-2027
2027-05-06,Phone Bill,-113.0,-10007.689999999995,BOA_7259,expense,Utilities,Phone,Monthly Service,"essential,monthly",Self,Phone Company,2027,05-2027,Q2-2027
2027-05-07,Insurance Payment,-367.0,-10374.689999999995,BOA_7259,expense,Insurance,Health Insurance,Monthly Premium,"essential,monthly",Self,Insurance Company,2027,05-2027,Q2-2027
2027-05-08,Netflix Subscription,-33.99,-10408.679999999995,BOA_7259,expense,Entertainment,Streaming,Video Streaming,"luxury,monthly",Self,Netflix,2027,05-2027,Q2-2027
2027-05-09,Spotify Subscription,-25.990000000000002,-10434.669999999995,BOA_7259,expense,Entertainment,Music,Streaming,"luxury,monthly",Self,Spotify,2027,05-2027,Q2-2027
2027-05-10,Transfer to Savings,-1009.0,-11443.669999999995,BOA_7259,expense,Transfer,Savings,Monthly Transfer,"essential,monthly",Self,Self,2027,05-2027,Q2-2027
2027-05-11,Transfer to Investment,-520.0,-11963.669999999995,BOA_7259,expense,Transfer,Investment,Monthly Investment,"essential,monthly",Self,Self,2027,05-2027,Q2-2027
2027-05-12,Transfer to Credit Card,-1520.0,-13483.669999999995,BOA_7259,expense,Transfer,Credit Card,Payment,"essential,monthly",Self,Self,2027,05-2027,Q2-2027
2027-05-13,ATM Withdrawal,-209.0,-13692.669999999995,BOA_7259,expense,Transfer,Cash,ATM Withdrawal,"essential,monthly",Self,Self,2027,05-2027,Q2-2027
2027-05-14,Grocery Store,-480.0,-14172.669999999995,BOA_7259,expense,Food & Dining,Groceries,Daily Groceries,"essential,monthly",Self,Grocery Store,2027,05-2027,Q2-2027
2027-05-19,Grocery Store,-431.0,-14603.669999999995,BOA_7259,expense,Food & Dining,Groceries,Daily Groceries,"essential,monthly",Self,Grocery Store,2027,05-2027,Q2-2027
2027-05-25,Grocery Store,-469.0,-15072.669999999995,BOA_7259,expense,Food & Dining,Groceries,Daily Groceries,"essential,monthly",Self,Grocery Store,2027,05-2027,Q2-2027
2027-05-26,Grocery Store,-449.0,-15521.669999999995,BOA_7259,expense,Food & Dining,Groceries,Daily Groceries,"essential,monthly",Self,Grocery Store,2027,05-2027,Q2-2027
2027-06-02,Gas Station,-85.0,-15606.669999999995,BOA_7259,expense,Transportation,Fuel,Gasoline,"essential,monthly",Self,Gas Station,2027,06-2027,Q2-2027
2027-06-06,Gas Station,-84.0,-15690.669999999995,BOA_7259,expense,Transportation,Fuel,Gasoline,"essential,monthly",Self,Gas Station,2027,06-2027,Q2-2027
2027-06-08,Gas Station,-46.0,-15736.669999999995,BOA_7259,expense,Transportation,Fuel,Gasoline,"essential,monthly",Self,Gas Station,2027,06-2027,Q2-2027
2027-06-15,Starbucks,-28.0,-15764.669999999995,BOA_7259,expense,Food & Dining,Coffee,Takeout,"luxury,monthly",Self,Starbucks,2027,06-2027,Q2-2027
2027-06-17,Starbucks,-1.0,-15765.669999999995,BOA_7259,expense,Food & Dining,Coffee,Takeout,"luxury,monthly",Self,Starbucks,2027,06-2027,Q2-2027
2027-06-22,Starbucks,9.0,-15756.669999999995,BOA_7259,expense,Food & Dining,Coffee,Takeout,"luxury,monthly",Self,Starbucks,2027,06-2027,Q2-2027
2027-06-23,Starbucks,-32.0,-15788.669999999995,BOA_7259,expense,Food & Dining,Coffee,Takeout,"luxury,monthly",Self,Starbucks,2027,06-2027,Q2-2027
2027-06-30,Target,-62.0,-15850.669999999995,BOA_7259,expense,Shopping,Retail,Household Items,"essential,monthly",Self,Target,2027,06-2027,Q2-2027
2027-07-04,Target,-55.0,-15905.669999999995,BOA_7259,expense,Shopping,Retail,Household Items,"essential,monthly",Self,Target,2027,07-2027,Q3-2027
2027-07-10,Costco,-199.0,-16104.669999999995,BOA_7259,expense,Food & Dining,Groceries,Bulk Shopping,"essential,monthly",Self,Costco,2027,07-2027,Q3-2027
2027-07-15,Costco,-211.0,-16315.669999999995,BOA_7259,expense,Food & Dining,Groceries,Bulk Shopping,"essential,monthly",Self,Costco,2027,07-2027,Q3-2027
2027-07-19,Costco,-207.0,-16522.669999999995,BOA_7259,expense,Food & Dining,Groceries,Bulk Shopping,"essential,monthly",Self,Costco,2027,07-2027,Q3-2027
2027-07-23,Costco,-230.0,-16752.669999999995,BOA_7259,expense,Food & Dining,Groceries,Bulk Shopping,"essential,monthly",Self,Costco,2027,07-2027,Q3-2027
2027-07-29,Restaurant,-83.0,-16835.669999999995,BOA_7259,expense,Food & Dining,Dining Out,Casual Dining,"luxury,monthly",Self,Restaurant,2027,07-2027,Q3-2027
2027-08-03,Movie Theater,-43.0,-16878.669999999995,BOA_7259,expense,Entertainment,Movies,Cinema,"luxury,monthly",Self,Movie Theater,2027,08-2027,Q3-2027
2027-08-12,Pet Store,-48.0,-16926.669999999995,BOA_7259,expense,Shopping,Pets,Pet Supplies,"essential,monthly",Self,Pet Store,2027,08-2027,Q3-2027
2027-08-18,Doctor Visit,-33.0,-16959.669999999995,BOA_7259,expense,Healthcare,Medical,Primary Care,"essential,monthly",Self,Healthcare Provider,2027,08-2027,Q3-2027
2027-08-19,Pharmacy,-67.0,-17026.669999999995,BOA_7259,expense,Healthcare,Prescriptions,Medication,"essential,monthly",Self,Pharmacy,2027,08-2027,Q3-2027
2027-08-20,Home Depot,-125.0,-17151.669999999995,BOA_7259,expense,Shopping,Home Improvement,Hardware,"essential,one-time",Self,Home Depot,2027,08-2027,Q3-2027
2027-08-27,Bookstore,-35.0,-17186.669999999995,BOA_7259,expense,Education,Books,Personal Development,"luxury,one-time",Self,Bookstore,2027,08-2027,Q3-2027
2027-08-30,Mother's Day Gift,-120.0,-17306.669999999995,BOA_7259,expense,Shopping,Gifts,Holiday,"luxury,one-time",Self,Retail Store,2027,08-2027,Q3-2027
2027-09-01,Salary Deposit,8500.0,-8806.669999999995,BOA_7259,income,Income,Salary,Primary Income,"essential,monthly",Employer,Self,2027,09-2027,Q3-2027
2027-09-02,Interest Payment,17.0,-8789.669999999995,BOA_7259,income,Income,Interest,Bank Interest,"essential,monthly",Bank,Self,2027,09-2027,Q3-2027
2027-09-03,Mortgage Payment,-3206.0,-11995.669999999995,BOA_7259,expense,Housing,Mortgage,Principal & Interest,"essential,monthly",Self,Bank,2027,09-2027,Q3-2027
2027-09-04,Utility Bill,-177.0,-12172.669999999995,BOA_7259,expense,Utilities,Electricity,Monthly Bill,"essential,monthly",Self,Utility Company,2027,09-2027,Q3-2027
2027-09-05,Internet Bill,-74.99,-12247.659999999994,BOA_7259,expense,Utilities,Internet,Monthly Service,"essential,monthly",Self,Internet Provider,2027,09-2027,Q3-2027
2027-09-06,Phone Bill,-88.0,-12335.659999999994,BOA_7259,expense,Utilities,Phone,Monthly Service,"essential,monthly",Self,Phone Company,2027,09-2027,Q3-2027
2027-09-07,Insurance Payment,-345.0,-12680.659999999994,BOA_7259,expense,Insurance,Health Insurance,Monthly Premium,"essential,monthly",Self,Insurance Company,2027,09-2027,Q3-2027
2027-09-08,Netflix Subscription,-0.9900000000000002,-12681.649999999994,BOA_7259,expense,Entertainment,Streaming,Video Streaming,"luxury,monthly",Self,Netflix,2027,09-2027,Q3-2027
2027-09-09,Spotify Subscription,-27.990000000000002,-12709.639999999994,BOA_7259,expense,Entertainment,Music,Streaming,"luxury,monthly",Self,Spotify,2027,09-2027,Q3-2027
2027-09-10,Transfer to Savings,-1013.0,-13722.639999999994,BOA_7259,expense,Transfer,Savings,Monthly Transfer,"essential,monthly",Self,Self,2027,09-2027,Q3-2027
2027-09-11,Transfer to Investment,-516.0,-14238.639999999994,BOA_7259,expense,Transfer,Investment,Monthly Investment,"essential,monthly",Self,Self,2027,09-2027,Q3-2027
2027-09-12,Transfer to Credit Card,-1489.0,-15727.639999999994,BOA_7259,expense,Transfer,Credit Card,Payment,"essential,monthly",Self,Self,2027,09-2027,Q3-2027
2027-09-13,ATM Withdrawal,-198.0,-15925.639999999994,BOA_7259,expense,Transfer,Cash,ATM Withdrawal,"essential,monthly",Self,Self,2027,09-2027,Q3-2027
2027-09-14,Grocery Store,-454.0,-16379.639999999994,BOA_7259,expense,Food & Dining,Groceries,Daily Groceries,"essential,monthly",Self,Grocery Store,2027,09-2027,Q3-2027
2027-09-18,Grocery Store,-452.0,-16831.639999999992,BOA_7259,expense,Food & Dining,Groceries,Daily Groceries,"essential,monthly",Self,Grocery Store,2027,09-2027,Q3-2027
2027-09-24,Grocery Store,-477.0,-17308.639999999992,BOA_7259,expense,Food & Dining,Groceries,Daily Groceries,"essential,monthly",Self,Grocery Store,2027,09-2027,Q3-2027
2027-09-28,Gas Station,-88.0,-17396.639999999992,BOA_7259,expense,Transportation,Fuel,Gasoline,"essential,monthly",Self,Gas Station,2027,09-2027,Q3-2027
2027-10-02,Gas Station,-74.0,-17470.639999999992,BOA_7259,expense,Transportation,Fuel,Gasoline,"essential,monthly",Self,Gas Station,2027,10-2027,Q4-2027
2027-10-04,Starbucks,-5.0,-17475.639999999992,BOA_7259,expense,Food & Dining,Coffee,Takeout,"luxury,monthly",Self,Starbucks,2027,10-2027,Q4-2027
2027-10-10,Starbucks,-20.0,-17495.639999999992,BOA_7259,expense,Food & Dining,Coffee,Takeout,"luxury,monthly",Self,Starbucks,2027,10-2027,Q4-2027
2027-10-11,Target,-95.0,-17590.639999999992,BOA_7259,expense,Shopping,Retail,Household Items,"essential,monthly",Self,Target,2027,10-2027,Q4-2027
2027-10-18,Target,-95.0,-17685.639999999992,BOA_7259,expense,Shopping,Retail,Household Items,"essential,monthly",Self,Target,2027,10-2027,Q4-2027
2027-10-22,Target,-108.0,-17793.639999999992,BOA_7259,expense,Shopping,Retail,Household Items,"essential,monthly",Self,Target,2027,10-2027,Q4-2027
2027-10-28,Costco,-246.0,-18039.639999999992,BOA_7259,expense,Food & Dining,Groceries,Bulk Shopping,"essential,monthly",Self,Costco,2027,10-2027,Q4-2027
2027-11-03,Costco,-210.0,-18249.639999999992,BOA_7259,expense,Food & Dining,Groceries,Bulk Shopping,"essential,monthly",Self,Costco,2027,11-2027,Q4-2027
2027-11-07,Costco,-247.0,-18496.639999999992,BOA_7259,expense,Food & Dining,Groceries,Bulk Shopping,"essential,monthly",Self,Costco,2027,11-2027,Q4-2027
2027-11-14,Restaurant,-94.0,-18590.639999999992,BOA_7259,expense,Food & Dining,Dining Out,Casual Dining,"luxury,monthly",Self,Restaurant,2027,11-2027,Q4-2027
2027-11-20,Movie Theater,-47.0,-18637.639999999992,BOA_7259,expense,Entertainment,Movies,Cinema,"luxury,monthly",Self,Movie Theater,2027,11-2027,Q4-2027
2027-11-27,Clothing Store,-101.0,-18738.639999999992,BOA_7259,expense,Shopping,Clothing,Apparel,"luxury,monthly",Self,Clothing Store,2027,11-2027,Q4-2027
2027-12-04,Pet Store,-41.0,-18779.639999999992,BOA_7259,expense,Shopping,Pets,Pet Supplies,"essential,monthly",Self,Pet Store,2027,12-2027,Q4-2027
2027-12-07,Doctor Visit,-42.0,-18821.639999999992,BOA_7259,expense,Healthcare,Medical,Primary Care,"essential,monthly",Self,Healthcare Provider,2027,12-2027,Q4-2027
2027-12-14,Oil Change,-42.0,-18863.639999999992,BOA_7259,expense,Transportation,Car Maintenance,Service,"essential,monthly",Self,Car Service,2027,12-2027,Q4-2027
2027-12-21,Bookstore,-21.0,-18884.639999999992,BOA_7259,expense,Education,Books,Personal Development,"luxury,one-time",Self,Bookstore,2027,12-2027,Q4-2027
2028-01-03,Back to School Shopping,-300.0,-19184.639999999992,BOA_7259,expense,Education,School Supplies,Annual,"essential,annual",Self,Retail Store,2028,01-2028,Q1-2028
